37
/                                                                                   
                                                                                    
    ###########################################################################     
    #                                                                        $#     
    #                       # #  ####  ##  #  ###  # #                        #     
    #                        #   #  #  # # #   #    #                         #     
    #                       # #  #  #  #  ##  ###  # #                        #     
    #                                                                         #     
    #                                                                         #     
    #                          %                                              #     
    #                                                                         #     
    #                                                                         #     
    #                                                                         #     
    #                                    !                                    #     
    #         #            #                         #            #           #     
    #         #            #                         #            #           #     
    #         #            #            #            #            #           #     
    #         #      !     #            #            #            #           #     
    #         #            #            #            #            #           #     
    #         #        ### #            #      !     # ###        #           #     
    #         #        #   #            #            #   #        #           #     
    #         ##############            #            ##############           #     
    #                                   #                                     #     
    #                                   #                                     #     
    #                                   #                                     #     
    #                                                                         #     
    #                                                                         #     
    #                   !                              %                      #     
    #                                                                         #     
    #                                                                         #     
    #            ###############################################              #     
    #                                                                         #     
    #                                                                        $#     
    ###########################################################################     
                                                                                    
                                                                                    
                                                                                    