37
/                                   @                                               
                                                                                    
    ###########################################################################     
    #                                                                        $#     
    #                       # #  ####  ##  #  ###  # #                        #     
    #                        #   #  #  # # #   #    #                         #     
    #                       # #  #  #  #  ##  ###  # #                        #     
    #                                                                         #     
    #                                                                         #     
    #                          %                                              #  @  
    #                                                                         #     
    #                                                                         #     
    #                                                                         #     
    #                                    !                                    #     
    #         #            #                         #            #           #     
    #         #            #                         #            #           #     
    #         #            #                         #            #           #     
    #         #      !     #                         #            #           #     
    #         #            #                         #            #           #     
    #         #        ### #                   !     # ###        #           #     
    #         #        #   #                         #   #        #           #     
    #         ##############                         ##############           #     
    #                                                                         #     
    #                                                                         #     
    #                                                                         #     
    #                                                                         #     
    #                                                                         #     
    #                   !                              %                      #     
    #                                                                         #     
    #                                                                         #     
    #            ###############################################              #     
    #                                                                         #     
    #                                                                        $#     
    ###########################################################################     
                                                                                    
                                 @                                                  
                                                                                    