10
/        
#########
#!      #
#       #
#   #   #
#   #   #
#       #
#       #
#      !#
#########